            
 ########## 
 #        # 
 #   >    # 
 #        # 
 #e       # 
    e     # 
 #e       # 
 ########## 
             