            
 ≈≈≈≈o≈≈≈≈≈ 
 ≈☼      ☼≈ 
 ≈ g      ≈ 
 ≈        ≈ 
 ≈    g   ≈ 
 o   O    o 
 ≈        ≈ 
 ≈ g      ≈ 
 ≈    g   ≈ 
 ≈☼      ☼≈ 
 ≈≈≈≈o≈≈≈≈≈
            